+-+-+-+-+-+-+-+-+-+-+-+-+-+-+-+-+-+-+-+-+-+-+-+-+-+
############|   |       |     |       |       |   |
+-+-+-+-+-+#+-+ + +-+-+ + +-+ + +-+ + + +-+-+ + + +
|#####|    #|   | |     | |   | | | | |   |     | |
+#+ +#+-+-+#+ +-+ + +-+-+ + +-+ + + + +-+-+ +-+-+ +
|#| |#|#####|   | | |   | | |   |   |   |   |     |
+#+-+#+#+-+-+-+ + + +-+ + + + +-+-+-+-+-+ +-+ +-+-+
|#|###|###|   | | |   | | | | |           |   |   |
+#+#+-+ +#+-+ + + +-+ + + + + + + +-+-+-+-+ +-+-+ +
|#|###| |#|   | | |   | | |   | | |   |           |
+#+-+#+-+#+ +-+ +-+ +-+ + +-+-+ + + +-+ +-+ +-+-+-+
|###|#####|   |         | |     | |     | | |   | |
+-+#+-+-+-+-+ +-+-+ +-+ + + +-+-+ +-+-+-+ + + + + +
|  #####    | |   |   |   |   |   |   |   |   | | |
+ +-+-+#+-+ + + + +-+ +-+-+-+ + +-+ + + +-+-+ + + +
| | |  ###| |   | |   |       | |   | |       |   |
+ + + +-+#+ + +-+ + +-+-+-+-+-+ + + + +-+-+-+-+-+-+
| | | |###| | | |       |     | | | |       |     |
+ + + +#+-+ + + +-+ +-+ + +-+ + + +-+-+-+-+ + +-+ +
|   | |###|   |   | |   |   | |   |     |       | |
+-+-+ +-+#+-+-+-+ +-+ +-+-+-+ +-+-+ +-+ + +-+ + +-+
|###|   |#|     |     |     | |   |   | |   | |   |
+#+#+-+-+#+ +-+ +-+ +-+-+-+ + +-+ +-+-+ +-+ + +-+ +
|#|###|###| |   |   |           | |         |   | |
+#+-+#+#+-+ + +-+ +-+ +-+-+-+ + + + +-+-+-+-+ + +-+
|#|###|#| | |     |     |     |   | |   |     |   |
+#+#+-+#+ + +-+-+-+ +-+-+ + +-+-+-+ +-+ + +-+-+-+ +
|#|#####|   |###  | |   | | |     |     |   |###| |
+#+-+-+-+-+-+#+#+-+ + + + +-+ +-+ + +-+-+-+-+#+#+ +
|#|#####|   |#|#|   | | | |   |   |     |#####|#  |
+#+#+-+#+ + +#+#+ +-+-+ + + +-+ +-+-+-+-+#+-+-+#+-+
|###|###| | |#|#|#####| |   |   |#########| |###  |
+-+-+#+ + + +#+#+#+-+#+ +-+-+ +-+#+-+-+-+-+ +#+-+-+
|   |#| | | |#|###|###| |   | |###|   |   | |#|###|
+ + +#+ + + +#+-+ +#+-+ + + + +#+-+ + + + + +#+#+#+
| | |#| | | |###| |###| | |   |#|   |   |   |###|#|
+ +-+#+ +-+ +-+#+-+-+#+ +-+-+-+#+ +-+ +-+-+ +-+-+#+
| |  #|   | | |#|   |#|     |###|   |     | |#####|
+ + +#+-+ + + +#+ + +#+-+ + +#+-+-+ +-+-+ +-+#+-+-+
|   |###|   |###| |  #    | |#|     |       |###| |
+-+-+-+#+-+-+#+-+ +-+#+-+-+ +#+ +-+-+-+-+ + + +#+ +
|     |#######|   |###|     |#|     |     |   |#| |
+ +-+ +-+-+-+-+ +-+#+-+-+-+-+#+ +-+ + +-+-+-+-+#+ +
|   |   |       |###|#######|#| |   |         |###|
+-+ +-+ + +-+-+-+#+-+#+-+-+#+#+ + +-+-+-+-+-+ +-+#+
|     | | |#######|###|   |###| |   |     |   |  #|
+ + + +-+ +#+-+-+-+#+-+ + +-+-+-+-+ + +-+ + +-+-+#+
| | |     |#|#######| | |   |   | | |   |   |   |#|
+ +-+-+-+-+#+#+-+-+ + + + +-+ + + + +-+ +-+-+ + +#+
|         |###|     |   |     |     |   |     |  ##
+-+-+-+-+-+-+-+-+-+-+-+-+-+-+-+-+-+-+-+-+-+-+-+-+-+ 